/* Level 1 */

#########################
#$....#...........#....$#
#.###.#.#########.#.###.#
#.#...................#.#
#.#?###.###   ###.###.#.#
#.#.....         .....#.#
#...###.#       #.###...#
#.#.....         .....#.#
#.#.###.#########.###.#.#
#.#........?@?........#.#
#.###.#.#########.#.###.#
#$....#...........#....$#
#########################
