/* Level 1 */

#########?########??#####
#@....#...........#.....#
#.###.#.###???###.#.###.#
#.#...................#.#
#.#.###.###   ###.###.#.#
#.#.....#       #.....#.#
#...###.#       #.###...#
#.#.....# X X X #.....#.#
#.#.###.#########.###.#.#
#.#...................#.#
#.###.#.##????###.#.###.#
#.....#...........#.....#
#########################
